18 19 19 19 16 1 2 2 16 19 18 18 19 19 18 18 19 19 18 18 18 18 19 3 3 3 3 3 18 2 2 16 16 2 18 18 18 19 18 19 18 18 2 2 19 18 18 19 18 19 
18 19 18 18 19 19 18 19 16 3 3 1 2 19 19 18 19 19 19 19 2 16 1 2 2 3 3 3 3 3 3 3 3 3 3 3 3 3 3 3 3 19 19 3 3 3 3 3 3 18 
19 18 18 19 19 18 18 18 19 19 19 19 18 19 18 19 19 19 3 3 16 16 16 1 2 1 3 3 3 18 3 3 2 2 2 1 19 18 18 16 1 1 1 18 19 3 3 3 3 3 
18 3 3 3 3 2 2 16 1 16 16 2 2 3 3 3 3 2 16 16 16 2 3 3 3 3 3 3 3 3 3 3 3 3 3 3 3 3 3 3 3 18 18 19 18 18 18 3 3 3 
18 3 3 3 3 18 19 18 19 18 19 18 16 2 2 1 1 2 2 2 16 1 2 3 3 3 3 3 3 3 3 3 3 19 2 1 2 1 1 19 19 2 1 2 3 3 16 3 3 3 
19 18 19 18 3 3 3 3 3 3 3 16 16 2 1 3 3 3 3 3 3 3 19 18 3 3 1 2 2 3 18 19 18 19 18 19 3 18 18 19 19 18 18 3 2 16 16 2 2 16 
19 3 3 3 3 3 3 3 3 3 3 3 3 3 19 18 18 1 1 16 16 2 3 2 16 1 1 1 3 3 3 3 3 3 3 3 2 1 1 19 18 3 19 18 19 19 18 19 19 18 
19 3 3 16 16 1 2 2 3 3 3 3 3 3 3 2 2 2 16 1 16 2 2 16 1 3 3 3 3 3 2 3 3 3 3 3 3 3 3 3 3 19 19 19 1 2 16 1 16 3 
18 18 19 19 19 2 1 1 2 16 16 19 19 18 19 19 19 16 18 19 16 16 1 16 2 16 1 16 16 1 16 1 1 16 2 19 18 19 3 3 3 3 16 2 1 16 16 2 18 3 
18 3 3 18 19 19 3 3 3 3 3 3 3 3 2 2 16 16 2 16 1 16 3 3 2 2 2 16 1 16 2 2 16 2 1 1 1 16 16 1 16 2 2 16 16 1 1 2 16 16 
19 19 2 2 1 18 19 19 18 18 18 18 3 3 3 3 3 3 19 18 3 2 1 1 1 2 16 1 16 2 19 18 19 19 19 18 19 19 19 3 3 2 3 3 3 3 3 3 3 3 
18 3 3 3 3 3 3 3 2 3 3 3 3 3 3 3 2 1 2 16 2 2 3 3 3 3 3 3 3 3 3 2 2 3 3 3 3 3 3 3 1 2 2 2 16 1 2 16 2 18 
19 18 19 18 18 19 19 18 18 18 3 3 3 3 3 3 3 18 19 19 19 18 19 19 18 19 18 18 1 1 3 3 3 3 3 3 3 18 18 19 18 19 18 18 19 19 18 19 19 18 
18 3 3 3 3 3 3 3 3 3 3 3 3 3 3 3 3 3 18 2 16 2 3 3 3 16 1 2 1 16 2 2 16 2 1 16 2 3 3 3 3 3 3 3 3 3 3 3 3 3 
19 3 19 19 19 18 19 1 1 2 1 19 18 19 19 3 3 3 2 2 3 2 2 1 2 1 16 16 1 16 16 2 1 16 2 18 18 19 19 3 3 3 1 2 1 16 3 18 18 19 
18 19 19 1 2 19 19 19 18 18 19 18 18 2 16 16 16 1 1 1 16 2 18 3 3 2 16 2 2 2 3 3 3 3 3 3 2 2 16 16 16 16 16 16 1 16 1 3 3 3 
19 3 16 2 1 16 1 16 1 2 16 16 19 18 19 18 19 1 1 2 2 2 1 1 16 1 16 19 2 1 1 16 16 1 1 2 3 3 3 1 3 19 3 3 2 3 3 3 3 3 
18 3 3 3 3 3 3 19 19 18 19 19 18 18 19 19 19 18 19 19 18 19 18 18 18 19 3 3 3 18 3 3 3 3 3 18 19 18 19 18 18 19 19 19 19 18 18 18 18 19 
19 19 2 1 1 2 2 2 2 16 19 19 19 19 19 19 18 18 3 3 3 3 3 3 3 3 3 16 2 16 2 2 3 19 18 19 19 18 19 19 18 18 18 18 18 18 19 19 18 19 
19 18 19 19 18 19 3 3 3 3 3 3 3 3 3 3 3 3 3 3 16 16 18 18 18 18 18 19 18 19 19 19 19 19 16 16 1 1 3 3 3 3 3 3 3 3 3 3 3 3 
19 3 3 3 1 16 16 1 16 1 1 2 2 1 16 1 1 3 18 3 3 3 16 16 3 3 3 3 3 3 19 18 19 19 19 19 19 19 18 16 16 16 16 1 18 19 19 19 3 3 
18 3 3 3 3 3 3 3 3 3 18 18 3 3 3 3 3 3 3 16 1 1 2 3 3 3 3 3 3 3 3 16 16 1 2 1 19 18 18 19 19 3 3 3 3 2 2 2 3 3 
19 3 16 18 19 18 19 18 18 18 18 19 19 19 19 19 19 18 19 18 18 19 3 3 3 18 18 19 19 18 18 19 3 3 3 3 3 3 3 3 3 3 3 19 19 18 19 19 19 1 
19 18 19 18 19 2 16 19 18 18 1 18 18 1 19 18 19 19 19 18 19 18 19 19 19 19 16 16 2 1 1 2 1 18 19 18 18 18 18 19 18 18 19 19 19 18 19 18 3 3 
19 3 3 3 3 3 3 3 3 3 3 3 3 3 3 1 3 3 3 1 1 2 16 16 2 16 16 1 1 2 16 1 3 3 19 19 19 19 3 3 3 3 3 3 3 3 3 3 3 19 
18 18 3 3 18 2 16 2 1 3 18 19 19 18 3 3 16 16 1 1 16 16 2 16 2 2 19 18 18 1 2 1 2 2 2 16 16 2 1 16 16 2 1 16 18 19 18 19 18 19 
19 19 18 18 18 3 3 3 3 18 19 19 18 2 2 16 2 18 18 3 3 3 3 3 18 19 3 3 18 18 3 19 1 2 2 2 2 2 16 16 3 3 3 3 3 3 3 3 19 19 
19 18 19 19 19 19 18 19 19 18 19 3 3 3 3 3 3 3 2 16 1 3 3 3 19 19 19 18 18 1 1 16 1 2 3 3 3 3 3 3 2 2 16 1 16 1 2 2 1 1 
18 2 2 1 1 18 18 18 19 19 18 19 19 18 19 19 18 3 3 3 3 19 19 19 18 19 19 18 19 18 19 18 18 19 18 18 18 18 19 18 18 18 18 18 1 16 1 2 1 3 
18 3 3 19 3 3 3 3 3 3 3 3 3 3 1 2 16 2 2 2 16 1 2 1 1 1 1 16 1 1 1 3 3 3 16 1 1 16 1 16 3 3 3 3 3 3 3 3 3 3 
18 3 3 3 3 3 3 3 3 18 18 19 19 19 18 18 18 19 16 16 18 18 19 19 19 18 18 18 18 16 3 3 3 3 1 1 2 1 2 3 3 3 3 3 3 3 16 2 16 16 
19 19 18 18 19 18 19 3 3 3 3 3 3 3 3 3 3 3 3 3 19 19 19 19 18 19 18 19 19 1 2 1 2 1 2 16 1 1 16 1 1 16 2 16 16 1 1 16 1 2 
18 16 3 3 3 3 3 3 3 3 3 3 3 3 3 3 2 1 2 1 1 2 2 16 16 2 19 3 3 3 3 3 3 3 3 3 3 3 3 19 18 16 1 1 16 16 16 16 16 19 
19 18 18 18 2 2 1 1 16 1 19 2 16 2 2 16 2 2 2 16 16 2 1 1 16 1 16 16 1 1 16 16 1 16 1 16 2 3 3 3 3 3 3 3 3 3 3 3 3 3 
18 3 3 1 16 2 16 1 2 2 2 1 1 16 2 1 16 16 1 16 16 18 19 18 18 18 18 19 19 19 18 18 19 19 18 18 18 19 18 19 18 18 18 3 3 3 3 3 3 3 
18 3 3 3 3 18 16 19 19 18 18 18 3 3 3 3 3 3 3 3 3 1 2 1 2 16 16 1 16 1 16 1 1 2 1 2 16 1 18 19 1 16 1 3 3 2 2 1 1 1 
19 16 3 3 18 1 1 16 16 1 2 16 2 1 2 1 16 16 19 18 18 18 19 19 19 3 3 3 3 3 3 3 3 3 3 3 3 3 3 3 3 3 3 3 3 3 3 16 2 3 
18 19 2 1 2 16 19 1 1 16 2 2 19 2 1 16 1 2 2 2 2 2 16 16 1 18 3 3 3 3 3 3 3 3 2 2 1 1 1 1 1 1 3 19 1 1 1 2 16 1 
19 16 2 1 1 1 1 2 16 1 2 1 2 19 18 18 18 18 18 19 19 3 3 3 3 3 3 3 3 3 3 3 3 18 3 3 3 3 3 3 3 3 3 3 3 3 3 3 3 3 
18 18 18 18 3 3 3 3 3 3 3 3 3 3 3 3 3 3 16 1 16 16 19 18 19 1 2 2 1 2 2 2 1 2 2 1 2 1 16 2 16 2 18 19 18 18 18 19 19 19 
19 19 18 3 3 3 3 3 3 3 3 3 3 3 3 3 3 16 16 18 18 19 18 18 3 3 3 3 1 1 18 3 3 3 3 19 18 19 19 19 18 19 18 3 3 3 3 3 3 3 
18 3 3 18 19 19 19 16 2 1 2 1 1 3 3 3 3 3 3 3 3 3 3 3 18 18 3 3 3 3 3 3 3 3 3 3 3 18 18 18 2 16 16 2 16 1 2 1 2 1 
19 16 3 3 3 3 3 3 3 3 3 19 18 18 19 19 18 19 18 19 19 18 18 18 18 18 19 18 18 19 19 18 19 18 18 18 18 19 18 19 18 19 19 19 19 18 19 18 18 19 
18 18 19 1 1 1 3 3 3 3 18 19 18 19 18 18 18 18 18 19 18 1 3 3 2 1 18 1 1 1 2 1 16 16 2 2 1 2 16 1 1 2 16 1 16 2 1 3 3 3 
18 3 3 3 3 3 3 3 3 3 3 3 3 3 1 2 16 2 2 2 3 3 3 3 3 3 3 18 18 19 19 18 19 18 18 19 18 3 3 3 3 3 3 3 3 19 19 18 18 19 
18 2 1 1 2 16 3 3 3 3 3 3 3 3 3 3 1 2 1 2 2 2 1 2 16 1 16 16 18 19 18 19 18 19 18 18 19 19 19 19 3 1 1 1 2 16 1 1 19 18 
19 16 2 1 16 1 16 16 16 1 2 1 2 16 16 16 16 2 2 16 16 2 3 18 19 3 3 3 1 16 2 2 1 3 3 3 3 3 3 3 3 3 3 3 3 3 3 3 18 18 
18 18 1 19 19 3 3 3 3 3 3 3 3 3 3 3 3 2 18 18 18 16 2 1 16 16 1 19 19 18 16 2 2 2 2 16 1 1 16 1 1 2 16 1 1 19 18 18 18 3 
19 19 19 18 19 19 18 19 19 2 1 3 3 18 19 19 19 19 19 19 18 18 3 3 3 3 3 3 3 3 16 16 1 2 16 16 2 1 2 3 3 3 3 3 19 19 19 19 1 3 
18 3 18 18 18 19 18 2 19 18 19 18 19 18 19 19 18 19 18 18 19 19 19 3 3 3 3 3 3 3 16 1 16 2 2 16 2 2 2 2 16 1 16 1 2 1 16 16 2 1 
