 0 16 3 3 3 3 3 3 3 3 3 3 3 3 3 3 3 2 10 1 10 1 10 2 10 2 10 16 16 16 16 1 10 3 3 3 3 1 10 16 1 10 1 10 2 10 3 3 3 
0 0 0 0 0 0 0 0 0 0 0 0 0 0 0 0 0 0 0 0 0 0 0 0 0 0 0 0 0 0 0 0 0 0 0 0 0 0 0 0 0 0 0 0 0 0 0 0 0 0 
3 0 1 10 3 3 3 3 3 3 1 10 1 10 16 16 3 3 3 3 2 10 16 2 10 16 1 10 16 2 10 16 1 10 2 10 3 3 3 3 3 3 3 16 1 10 1 10 3 3 
3 0 8 11 1 10 1 10 16 6 8 6 8 11 2 10 3 1 10 6 8 11 6 8 11 6 8 11 6 8 11 6 8 6 8 11 1 10 3 16 16 1 10 6 8 6 8 11 2 10 
16 0 3 6 8 6 8 11 1 10 2 10 16 6 8 11 6 8 11 16 3 3 3 3 3 3 1 10 16 1 10 16 1 10 16 6 8 11 3 1 10 8 11 2 10 2 10 6 8 11 
16 0 16 16 2 10 1 10 8 6 8 11 3 3 3 3 3 1 10 16 1 10 3 3 3 6 8 11 6 8 11 6 8 11 2 10 1 10 6 8 11 16 6 8 6 8 11 3 2 10 
1 0 1 10 8 6 8 11 3 3 3 3 3 3 16 2 10 8 11 6 8 11 3 3 3 3 3 3 3 3 3 3 3 6 8 6 8 11 1 10 16 16 1 10 2 10 3 6 8 5 
8 0 8 11 1 10 16 16 1 10 1 10 1 10 6 8 11 1 10 1 10 2 10 16 2 10 2 10 3 1 10 2 10 2 10 1 10 6 8 11 3 6 8 6 8 11 3 3 3 6 
16 0 16 6 8 11 2 10 8 6 8 6 8 11 16 2 10 8 6 8 6 8 11 6 8 6 8 11 6 8 6 8 6 8 6 8 11 3 3 3 3 3 3 16 1 10 2 10 16 2 
3 0 16 1 10 6 8 11 16 2 10 3 1 10 6 8 11 16 16 1 10 3 3 3 3 3 3 3 3 1 10 16 2 10 3 3 3 3 3 3 3 3 3 6 8 6 8 11 6 8 
2 0 6 8 11 1 10 16 6 8 11 6 8 11 3 3 3 3 6 8 11 3 3 3 3 3 16 16 6 8 11 6 8 11 16 3 3 3 3 3 3 3 3 3 3 3 3 3 3 5 
8 0 3 3 6 8 11 1 10 16 2 10 2 10 1 10 16 2 10 16 16 1 10 2 10 1 10 2 10 2 10 1 10 1 10 16 2 10 16 2 10 16 1 10 16 16 2 10 2 10 
1 0 3 3 3 3 6 8 11 6 8 6 8 6 8 11 6 8 11 1 10 8 6 8 6 8 6 8 6 8 6 8 6 8 11 6 8 11 6 8 11 6 8 11 3 6 8 6 8 5 
8 0 3 16 1 10 3 3 3 3 3 3 3 3 3 3 3 16 6 8 11 2 10 2 10 3 3 3 16 16 16 2 10 2 10 2 10 16 1 10 2 10 2 10 1 10 3 3 3 6 
16 0 16 6 8 11 1 10 16 16 16 1 10 16 2 10 2 10 3 3 6 8 6 8 11 2 10 2 10 3 6 8 6 8 6 8 11 6 8 6 8 6 8 6 8 11 3 3 3 3 
3 0 16 16 16 6 8 11 2 10 6 8 11 6 8 6 8 11 3 3 3 3 3 16 6 8 6 8 11 16 16 1 10 16 16 16 2 10 3 3 3 3 2 10 1 10 16 1 10 3 
16 0 2 10 16 2 10 6 8 11 2 10 16 16 16 16 1 10 1 10 16 2 10 2 10 16 1 10 16 1 10 8 11 16 1 10 8 11 3 3 3 6 8 6 8 11 6 8 11 2 
16 0 8 11 6 8 11 2 10 6 8 11 2 10 1 10 8 6 8 11 6 8 6 8 11 6 8 11 6 8 11 3 2 10 8 11 16 1 10 16 16 16 3 3 3 3 3 3 6 8 
2 0 3 3 3 3 6 8 11 3 16 6 8 6 8 11 2 10 2 10 16 1 10 3 3 3 3 3 3 3 3 6 8 11 3 3 6 8 11 16 1 10 1 10 3 3 3 3 3 5 
8 0 3 16 16 2 10 1 10 1 10 16 1 10 3 6 8 6 8 11 6 8 11 1 10 16 16 3 3 3 3 3 3 3 3 3 3 3 3 6 8 6 8 11 3 3 2 10 1 10 
3 0 3 3 6 8 6 8 6 8 11 6 8 11 2 10 1 10 16 3 3 3 6 8 11 3 3 3 3 3 3 3 3 3 3 2 10 1 10 2 10 1 10 1 10 6 8 6 8 11 
3 0 3 3 3 3 3 2 10 2 10 2 10 6 8 6 8 11 3 3 1 10 3 3 3 3 3 3 3 3 3 3 3 3 6 8 6 8 6 8 6 8 6 8 11 1 10 3 3 3 
3 0 2 10 2 10 6 8 6 8 6 8 11 16 16 1 10 16 2 10 8 11 3 3 3 3 16 16 2 10 1 10 1 10 16 16 2 10 3 3 3 3 1 10 6 8 11 3 3 3 
16 0 8 6 8 11 3 3 3 3 3 3 3 3 6 8 11 6 8 11 2 10 2 10 2 10 1 10 8 6 8 6 8 11 2 10 8 11 2 10 1 10 8 11 3 3 1 10 16 1 
1 0 1 10 2 10 1 10 2 10 16 3 3 3 3 3 3 3 3 6 8 6 8 6 8 6 8 11 2 10 1 10 16 6 8 11 16 6 8 6 8 11 1 10 1 10 8 11 6 5 
8 0 8 6 8 6 8 6 8 11 2 10 2 10 3 3 3 3 3 3 3 3 3 3 3 16 2 10 8 6 8 11 1 10 16 2 10 2 10 3 3 6 8 6 8 11 3 2 10 6 
1 0 2 10 3 2 10 2 10 6 8 6 8 11 3 3 3 1 10 3 3 3 3 3 3 6 8 11 3 3 16 6 8 11 6 8 6 8 11 1 10 2 10 16 16 16 6 8 11 5 
8 0 8 11 6 8 6 8 11 16 16 2 10 1 10 16 6 8 11 3 3 3 3 1 10 16 1 10 3 3 3 3 1 10 1 10 2 10 6 8 6 8 11 2 10 2 10 2 10 6 
2 0 3 2 10 1 10 2 10 2 10 8 6 8 11 3 3 3 3 3 16 16 6 8 11 6 8 11 2 10 2 10 8 6 8 6 8 11 1 10 1 10 6 8 6 8 6 8 11 5 
8 0 6 8 6 8 6 8 6 8 11 3 3 3 3 3 3 3 3 3 3 3 3 3 3 3 3 6 8 6 8 11 1 10 2 10 3 6 8 6 8 11 3 3 3 3 3 1 10 6 
3 0 16 2 10 3 3 3 3 3 3 3 3 16 16 1 10 3 3 3 3 3 3 3 1 10 1 10 2 10 3 6 8 6 8 11 16 2 10 3 3 1 10 1 10 1 10 8 11 2 
2 0 6 8 11 16 2 10 16 1 10 1 10 2 10 8 11 16 3 3 3 3 3 6 8 6 8 6 8 11 2 10 16 2 10 2 10 8 11 1 10 8 6 8 6 8 11 16 6 5 
8 0 2 10 3 6 8 11 6 8 6 8 6 8 11 16 2 10 2 10 2 10 16 2 10 1 10 1 10 6 8 11 6 8 6 8 11 16 6 8 11 2 10 1 10 3 3 3 3 6 
3 0 8 11 3 3 3 3 3 3 1 10 16 2 10 6 8 6 8 6 8 11 6 8 6 8 6 8 11 1 10 2 10 1 10 16 16 1 10 2 10 8 6 8 11 16 16 2 10 1 
1 0 16 2 10 1 10 1 10 6 8 11 6 8 11 2 10 1 10 3 3 3 1 10 3 3 3 3 6 8 6 8 6 8 11 3 6 8 6 8 11 1 10 2 10 1 10 8 6 5 
8 0 6 8 6 8 6 8 11 3 3 3 3 3 6 8 6 8 11 2 10 6 8 11 2 10 16 1 10 3 3 3 3 1 10 2 10 2 10 3 6 8 6 8 6 8 11 3 3 6 
3 0 3 3 3 3 3 3 1 10 2 10 1 10 16 16 16 1 10 8 11 3 3 6 8 11 6 8 11 16 1 10 6 8 6 8 6 8 11 3 3 3 3 3 3 3 2 10 2 10 
3 0 3 3 3 3 3 6 8 6 8 6 8 11 2 10 6 8 11 3 3 2 10 2 10 2 10 3 3 6 8 11 3 3 3 3 3 1 10 3 3 1 10 3 3 6 8 6 8 11 
1 0 3 3 3 3 3 3 3 3 2 10 2 10 8 11 1 10 3 3 6 8 6 8 6 8 11 3 3 3 3 3 3 3 16 16 6 8 11 3 6 8 11 3 3 3 1 10 2 10 
8 0 16 3 3 3 3 3 3 6 8 6 8 11 3 6 8 11 1 10 1 10 3 3 3 3 3 3 3 16 16 2 10 16 16 2 10 1 10 16 16 2 10 2 10 6 8 6 8 11 
16 0 3 16 2 10 2 10 3 3 3 3 3 3 1 10 3 6 8 6 8 11 3 3 3 2 10 3 1 10 6 8 11 1 10 8 6 8 11 1 10 8 6 8 11 3 3 3 3 3 
16 0 1 10 8 6 8 11 16 16 2 10 3 6 8 11 1 10 16 1 10 1 10 1 10 8 11 6 8 11 3 3 6 8 11 3 3 3 6 8 11 2 10 16 16 1 10 2 10 3 
3 0 8 11 2 10 16 1 10 6 8 11 2 10 2 10 8 11 6 8 6 8 6 8 11 2 10 3 1 10 3 3 3 3 3 3 1 10 3 3 6 8 11 1 10 8 6 8 11 3 
3 0 3 6 8 11 6 8 11 3 3 6 8 6 8 11 3 3 3 3 3 3 3 3 6 8 11 6 8 11 16 2 10 16 1 10 8 11 16 2 10 1 10 8 11 16 2 10 1 10 
1 0 2 10 16 2 10 1 10 3 3 3 3 3 3 3 3 3 3 3 16 2 10 3 16 2 10 3 3 3 6 8 11 6 8 11 3 3 6 8 6 8 11 3 3 6 8 6 8 5 
8 0 8 11 6 8 6 8 11 16 1 10 2 10 1 10 16 2 10 16 6 8 11 3 6 8 11 3 1 10 16 16 1 10 16 2 10 3 3 3 3 3 3 3 1 10 1 10 1 10 
16 0 16 2 10 2 10 16 16 6 8 6 8 6 8 11 6 8 11 3 3 3 3 3 3 3 1 10 8 11 2 10 8 11 6 8 11 3 3 3 3 3 3 6 8 6 8 6 8 11 
2 0 6 8 6 8 11 3 3 3 3 3 3 3 3 16 2 10 2 10 3 3 3 3 3 6 8 11 3 6 8 11 3 3 3 3 16 2 10 3 3 3 16 2 10 16 2 10 2 10 
8 0 1 10 16 1 10 1 10 3 16 16 1 10 1 10 8 6 8 11 3 3 3 2 10 16 16 1 10 16 1 10 3 3 3 3 6 8 11 1 10 1 10 8 11 6 8 6 8 11 
2 0 8 11 6 8 6 8 11 16 16 6 8 6 8 11 16 4 7 4 7 4 6 8 11 4 6 8 11 6 8 11 7 9 3 3 3 4 6 8 6 8 11 7 4 7 9 3 3 5 
